111111111111111111111
1E00000011100000000C1
100111000000111001101
100001111000101011001
10001100C001100001101
1100000010000000000C1
100C00011000011000011
100000011100001001111
111P00000000100000C11
111111111111111111111
